111111111111111111111111
10000111000000C000101001
101000VC001C001000100011
101001V01101110001011111
11C1C00C001100000V011001
10CC0C100P00V11000100C01
1010C00000110V0000000111
1V00E00V0101000110101011
100000001111011010000C01
100V1V000000C00000V01111
111111111111111111111111
