111111111111111111111111
10000111000000C000101001
10100V0C001C001000100011
101001001101110001011111
11C1C0VC0011000000V11001
10CC0C10000V011000100CE1
1010C0000011000000000111
1000000P01V10V0110101011
100000011111011010000C01
1V0V1V000000C00000V01111
111111111111111111111111
