11111111111111111111111
10000000100000000000001
1C000000100000000C00001
10000000100000000000001
10000000100000000000001
10000000E00000000000001
10000000100000000000001
100000001000000P0000001
10000000100000000000001
10000000100000000000001
11111111111111111111111