111111111111111111
101C0C100000001CC1
1011011000000000C1
100000000000000011
100000000000000001
100000001010000001
10000001CCC1000001
1000001CCCCC100001
1P0001CCCCCCC100E1
111111111111111111