11111111111111111111111
10000000000000000000001
1C100000000000000000001
11000000000000001C10001
10000000000000000100001
10000000E00000000000001
10000000000000000000001
100000000000000P0000001
10000000000000000000001
10000000000000000000001
11111111111111111111111