11111111
10C001E1
10000011
10P00001
11111111