1111111111111111
1C00P00C00000011
1000000001000C01
10010110C0101001
1110010001C10001
10110110000010C1
1C01100011C00001
1001CC00111101E1
1100000001101001
10C0011001010C11
1C00000100000001
1010010000000001
1100000100000011
1010100010001001
1000000C10000101
1000100100000001
10110001001C1001
1000000010100001
10C0000110000001
1C00100011001001
1000011000001101
1111111111111111
