11111111111111111111111
1000VVVV1VVVVVVVVVVVVV1
1C10VVVV1VVVVVV000VVVV1
11V0VVVV1VVVVV001C1VVV1
1VV0VVVV1VVVVV011111VV1
1VV0VVVVEVVVVV0VVVVVVV1
1VV0000000000000VVVVVV1
1VVVVVVV1VVVVVVPVVVVVV1
1VVVVVVV1VVVVVVVVVVVVV1
1VVVVVVV1VVVVVVVVVVVVV1
11111111111111111111111