111111111111111111
101c0c100000001cc1
1011011000000000c1
100000000000000011
100000000000000001
100000001010000001
10000001ccc1000001
1000001ccccc1000P1
100001ccccccc100E1
111111111111111111