111111111111111111111111111111111111111111
100011001000C0011001000C010001101010000011
1000100000C0010C00100100110000101C00C01011
100101001000101101000011000000101C11100001
10C000010000C0100000001CC00001010000000001
1001001C00000C00001010011010000C1001100001
10100001C0C0000000001010100001000100100001
11100001100000010C10000010100100111010C101
1010C000C00110000000011000010010C001001011
10C00011000E1110000011100C0000101001000011
1010C1011000C00000000000100001000000000101
101C1000000011C000000100100000001000000011
1100010000100000C0000001P000CC001010010101
101100000000000001100000C11000000000100001
110C0100100000C010000101000100110001001011
111111111111111111111111111111111111111111
